18
17
1 1 0 0 0 0 0 0 0 0 0 0 0 0 0 0 1 1 
2 2 0 0 0 0 0 0 0 0 0 0 0 0 0 0 1 1
2 2 0 0 0 0 0 0 0 0 0 0 0 0 0 0 2 2
2 2 0 0 0 0 0 0 0 0 0 0 0 0 0 0 2 2
2 2 0 0 0 0 0 0 0 0 0 0 0 0 0 4 2 2
2 2 0 0 0 3 0 0 0 0 0 0 0 1 1 1 2 2
2 2 0 0 0 0 0 0 0 0 0 0 0 0 0 0 2 2
2 2 1 0 0 0 0 0 0 0 0 3 0 0 0 0 2 2
2 2 0 0 1 1 1 0 0 0 0 0 0 0 0 0 2 2
2 2 0 0 2 2 2 1 0 0 0 0 0 0 0 0 2 2
2 2 0 0 0 0 0 0 0 0 0 0 0 0 0 0 2 2
2 2 0 0 0 0 0 0 0 0 0 0 0 0 0 0 2 2
2 2 0 0 0 0 0 0 0 0 0 0 0 1 1 1 2 2
2 2 1 1 1 1 1 1 1 0 0 0 0 2 2 2 2 2
2 2 2 2 2 2 2 2 1 1 1 1 1 1 2 2 2 2
2 2 1 2 2 2 2 2 2 2 2 2 2 2 2 2 2 2
2 2 2 2 2 2 2 2 2 2 2 2 2 2 2 2 2 2

2
8 10 3 9 16
1 5 3 8 11